00,00,00,00,00,00,00,00,00,00,00,00,00,00,00,00,00,00,00,00,00,00,00,00,00
00,01,01,01,01,01,01,01,01,01,01,01,00,01,01,01,01,01,01,01,01,01,01,01,00
00,01,01,00,00,01,01,00,00,00,01,01,00,01,01,00,00,00,01,01,00,00,01,01,00
00,01,01,00,00,01,01,00,00,00,01,01,00,01,01,00,00,00,01,01,00,00,01,01,00
00,01,01,01,01,01,01,01,01,01,01,01,00,01,01,01,01,01,01,01,01,01,01,01,00
00,01,01,00,00,01,01,00,01,01,01,01,01,01,01,01,01,00,01,01,00,00,01,01,00
00,01,01,01,01,01,01,00,01,01,01,00,00,00,01,01,01,00,01,01,01,01,01,01,00
00,00,00,00,00,01,01,00,00,00,01,01,00,01,01,00,00,00,01,01,00,00,00,00,00
00,01,01,01,00,01,01,00,01,01,01,01,00,01,01,01,01,00,01,01,00,01,01,01,00
00,00,00,00,00,01,01,00,01,01,01,01,01,01,01,01,01,00,01,01,00,00,00,00,00
00,01,01,01,01,01,01,01,01,01,00,00,01,00,00,01,01,01,01,01,01,01,01,01,00
00,00,00,00,00,01,01,00,01,01,00,01,01,01,00,01,01,00,01,01,00,00,00,00,00
00,01,01,01,00,01,01,00,01,01,00,01,01,01,00,01,01,00,01,01,00,01,01,01,00
00,00,00,00,00,01,01,00,01,01,00,00,00,00,00,01,01,00,01,01,00,00,00,00,00
00,01,01,01,01,01,01,01,01,01,01,01,01,01,01,01,01,01,01,01,01,01,01,01,00
00,01,01,00,00,01,00,00,00,00,01,00,00,00,01,00,00,00,00,01,00,00,01,01,00
00,00,01,01,00,01,01,01,01,00,01,01,00,01,01,00,01,01,01,01,00,01,01,00,00
00,01,01,01,01,01,01,01,01,00,01,01,01,01,01,00,01,01,01,01,01,01,01,01,00
00,01,01,01,00,01,01,01,01,01,01,01,00,01,01,01,01,01,01,01,00,01,01,01,00
00,00,00,00,00,00,00,00,00,00,00,00,00,00,00,00,00,00,00,00,00,00,00,00,00

1,1,1,1,1,1,1,1,1,1,1,1,1,1,1,1,1,1,1,1,1,1,1,1,1
1,2,2,2,2,2,2,2,2,2,2,2,1,2,2,2,2,2,2,2,2,2,2,2,1
1,3,2,1,1,2,2,1,1,1,2,2,1,2,2,1,1,1,2,2,1,1,2,3,1
1,2,2,1,1,2,2,1,1,1,2,2,1,2,2,1,1,1,2,2,1,1,2,2,1
1,2,2,2,2,2,2,2,2,2,2,2,1,2,2,2,2,2,2,2,2,2,2,2,1
1,2,2,1,1,2,2,1,2,2,2,2,2,2,2,2,2,1,2,2,1,1,2,2,1
1,2,2,2,2,2,2,1,2,2,2,1,1,1,2,2,2,1,2,2,2,2,2,2,1
1,1,1,1,1,2,2,1,1,1,2,2,1,2,2,1,1,1,2,2,1,1,1,1,1
1,0,0,0,1,2,2,1,2,2,2,2,1,2,2,2,2,1,2,2,1,0,0,0,1
1,1,1,1,1,2,2,1,2,2,2,2,2,2,2,2,2,1,2,2,1,1,1,1,1
1,2,2,2,2,2,2,2,2,2,1,1,0,1,1,2,2,2,2,2,2,2,2,2,1
1,1,1,1,1,2,2,1,2,2,1,0,0,0,1,2,2,1,2,2,1,1,1,1,1
1,0,0,0,1,2,2,1,2,2,1,0,0,0,1,2,2,1,2,2,1,0,0,0,1
1,1,1,1,1,2,2,1,2,2,1,1,1,1,1,2,2,1,2,2,1,1,1,1,1
1,2,2,2,2,2,2,2,2,2,2,2,2,2,2,2,2,2,2,2,2,2,2,2,1
1,2,2,1,1,2,1,1,1,1,2,1,1,1,0,1,1,1,1,2,1,1,2,2,1
1,1,2,2,1,2,2,2,2,1,2,2,1,2,2,1,2,2,2,2,1,2,2,1,1
1,3,2,2,2,2,2,2,2,1,2,2,2,2,2,1,2,2,2,2,2,2,2,3,1
1,2,2,2,1,2,2,2,2,2,2,2,1,2,2,2,2,2,2,2,1,2,2,2,1
1,1,1,1,1,1,1,1,1,1,1,1,1,1,1,1,1,1,1,1,1,1,1,1,1